NO ./path_to_the_north_texture
SO ./path_to_the_south_texture
WE ./path_to_the_west_texture
EA ./path_to_the_east_texture

F 220,100,0
C 225,30,0

        1111111111111111111111111
        1000000000110000000000001
        1011000001110000000000001
        1001000000000000000000001
111111111011000001110000000000001
100000000011000011111111111111111
11110111111111011100000000001
11110111111111011100000000001
11000000000001011100000000001
10000010010000001100000000001
10000000000000001100000000001
11001000000010011100000N0000111111111111111
11110111111101011100000000001
11111111111111111111111111111