                             NO ./textures/cool.png
           SO ./textures/cool.png
          WE ./textures/cool.png
EA ./textures/cool.png

F 0   ,  0,   0
C 0,     0,   0

1111111111111111111111111111111
1000000000000000000000000001111
1000000000000000000000000011001
100000S000000000000000000011111
1000000000001111111111111111111
1000000000001
1000000000001111111111111111111  
1000000000000000000000000000001
1000000000000000000000000000001
1000000000000000000000000000001
1111111111111111111100000000001
                   100000000001
                   100000000001
                   100000000001
                   100000000001
1111111111111111111100000000001
1000000000000000000000000000001
1000000000000000000000000000001
1000000000000000000000000000001
1000000000001111111111111111111
1000000000001
1000000000001111111111111111111  
1000000000000000000000000000001
1000000000000000000000000000001
1000000000000000000000000000001
1111111111111111111100000000001
                   100000000001
                   100000000001
                   100000000001
                   100000000001
1111111111111111111100000000001
1000000000000000000000000000001
1000000000000000000000000000001
1000000000000000000000000000001
1000000000001111111111111111111
1000000000001
1000000000001111111111111111111 
1000000000000000000000000000001
1000000000000000000000000000001
1000000000000000000000000000001
1111111111111111111100000000001
                   100000000001
                   100000000001
                   100000000001
                   100000000001
1111111111111111111100000000001
1000000000000000000000000000001
1000000000000000000000000000001
1000000000000000000000000000001
1111111111111111111111111111111
