NO ./path_to_the_north_texture
SO ./path_to_the_south_texture
WE ./path_to_the_west_texture
EA ./path_to_the_east_texture

F 220,100,0
C 225,30,0

1111111111111111111111111111111
1N00000000000000000000000000001
1000000000000000000000000000001
1000010000001000000010000000001
1000000000000000000000000000001
1000000010000000010000001000001
1000000000000000000000000000001
1000000000101000000000000000001
1000000000101000000000000000001
1000000000101000000000000000001
1000000000101000000000000000001
1111111111111111111111111111111