                          NO ./textures/cool.png


                 SO ./textures/cool.png



WE ./textures/cool.png

EA ./textures/cool.png


F 220,100,0


C 225,30,0

        1111111111111111111111111
        1002000000110000000000001
        1011000001110000000000001
111111111001000000200000000000001
111000000011000001110111121111111
11112111111111011100000010001
11110111111111011101010010001
11000000000001211100000010001
10000010010000001100000010001
10000000000000001101010010001
11001000000010011111011110N01
11110111111101011101111010001
11111111111111111111111111111
