NO ./textures/BRICK_3D.PNG
SO ./textures/BRICK_3D.PNG
WE ./textures/BRICK_3D.PNG
EA ./textures/BRICK_3D.PNG

F 128,128,128
C 153,204,255

1111111111111111111111111111111
1000000000000000000000001000001
1000000001000000001000000000001
1000001000000000000000001000001
1000000001000000001000000000001
1000001000000000000000001000001
1000000001000000001000000000001
1000001000000000000000001000001
1000000001000001001000000000001
100000100000000N000000001000001
1000000001000000001000000000001
1111111111111111111111111111111