                          NO ./textures/cool.png


                 SO ./textures/cool.png



WE    ./textures/cool.png

EA ./textures/cool.png


F 220,100,0


C 225,30,0

1111111111111111111111111111111111111111111111111111
1222222222222222222222222222222222222222222222222221
1222222222222222222222222222222222222222222222222221
1222222222222222222222222222222222222222222222222221
1222222222222222222222222222222222222222222222222221
1222222222222222222222222222222222222222222222222221
1222222222222222222222222222222222222222222222222221
1222222222222222222222222222222222222222222222222221
1222222222222222222222222222222222222222222222222221
1222222222222222222222222222222222222222222222222221
1222222222222222222222222222222222222222222222222221
1222222222222222222222222N22222222222222222222222221
1222222222222222222222222222222222222222222222222221
1222222222222222222222222222222222222222222222222221
1222222222222222222222222222222222222222222222222221
1222222222222222222222222222222222222222222222222221
1222222222222222222222222222222222222222222222222221
1222222222222222222222222222222222222222222222222221
1222222222222222222222222222222222222222222222222221
1222222222222222222222222222222222222222222222222221
1111111111111111111111111111111111111111111111111111
