NO ./textures/SUPPORT_4A.PNG

SO ./textures/WOOD_1C.PNG

WE ./textures/BRICK_6D.PNG

EA ./textures/LIGHT_1B.PNG


F 128,128,128
C 10,150,220

1111111111111111111111111111111
1000000000000000000000000000001
1000000000000000000000000000001
1000000000000000000000000000001
1000000000000000000000000000001
1000000000000000000000000000001
1000000000000000000000000000001
1000000000000000000000000000001
1000000000000000000000000000001
1000000000000000N00000000000001
1000000000000000000000000000001
1000000000000000000000000000001
1000000000000000000000000000001
1111111111111111111111111111111
