NO ./textures/DOOR_1A.PNG
SO ./textures/DOOR_1A.PNG
WE ./textures/DOOR_1A.PNG
EA ./textures/DOOR_1A.PNG

F 255,0,0
C 0,0,0

1111111111111111111111111111111
1000020000000002000000000002001
1000011111111111111111111111001
1000020000000000200001002001111
1121111111100000100002001000001
1000020011111111111111111111111
1000010010000002000000100020001
1011111110011111111100100010001
1010000010010200000000100010001
1011110010011111111100100010001
1000200010010000000000100010001
1111111210010011111111100010001
1000000000010000000000000010N01
1111111111111111111111111111111